1E1111
101011
100001
110101
111101