1111111111111
1000000000001
1010110101101
1001000011001
1101000011011
100011E100001
1011111101101
1010010001001
1000011111011
1111110001001
0001010101101
1100000100001
1111111111111