111111111111111111111111111111111111111111111111111111111111
100001000110100010011000010001101000100110000100011010001001
110000011010001111011100000110100011110111000001101000111101
E00001001000000001010000010010000000010110000100100000000101
101000101011000101111010001010110001011110100010101100010111
110000000001111000111100000000011110001111000000000111100011
100100100010000000111001001000100000001110010010001000000011
100101101001010010011001011010010100100110010110100101001001
101000100000101000111010001000001010001110100010000010100011
100010100001001101011000101000010011010000001010000100110101
100100110000000010011001001100000000100110010011000000001001
100001010100011110011000010101000111100110000101010001111001
101001100001010100011010011000010101000110100110000101010001
100000100000001100011000001000000011000110000010000000110001
100000100100011000011000001001000110000110000010010001100001
100000001100000000011000000011000000000110000000110000000001
100000000000000111011000000000000001110110000000000000011101
101100001001100101000011000010011001010100110000100110010101
100111000000000010011001110000000000100110011100000000001001
111111111111111111111111111111111111111111111111101111111111
111111111111111111111111111111111111111111111111101111111111
100001000110100010011000010001101000100110000100001010001001
110000011010001111011100000110100011110111000001101000111101
000001001000000001010000010010000000010110000100100000000101
101000101011000101111010001010110001011110100010101100010111
110000000001111000111100000000011110001111000000000111100011
100100100010000000111001001000100000001110010010001000000011
100101101001010010011001011010010100100110010110100101001001
101000100000101000111010001000001010001110100010000010100011
100010100001001101011000101000010011010000001010000100110101
100100110000000010011001001100000000100110010011000000001001
100001010100011110011000010101000111100110000101010001111001
101001100001010100011010011000010101000110100110000101010001
100000100000001100011000001000000011000110000010000000110001
100000100100011000011000001001000110000110000010010001100001
100000001100000000011000000011000000000110000000110000000001
100000000000000111011000000000000001110110000000000000011101
101100001001100101000011000010011001010100110000100110010101
100111000000000010011001110000000000100110011100000000001001
111111111111111111111111111111111111111111111111111111111111