11E111011
100000111
101111011
100000011
111111111